21x20
#####################
#                   #
#   #o#o#o#o#o#o#   #
#   #o#o#o#o#o#o#   #
#   #E#o#E#E#o#E#   #
#         #         #
#   #############   #
#                   #
#   #o#o#o#o#o#o#   #
#   #o#o#o#o#o#o#   #
#   #o#o#o#o#o#o#   #
#         #         #
#   #############   #
#         #         #
#   #o#o#o#o#o#o#   #
#   #o#o#o#o#o#o#   #
#   #o#o#o#o#o#o#   #
#                   #
#P                  #
#####################