15x15
###############
#ooooooooooooo#
#o####ooo####o#
#o#ooooEoooo#o#
#o#####o#####o#
#ooooooEoooooo#
####ooo#ooo####
#ooooooooooooo#
#oo###ooo###oo#
#oooooo*oooooo#
#ooooooooooooo#
#o####o#o####o#
#o##oooPooo##o#
#oooooo#oooooo#
###############