19x18
###################
#_______#ooo___ooo#
#o##_##o#o##_#_##o#
#o#_o_#o#oE#_#_#Eo#
#o#_#_#o#o##_#_##o#
#___#___#____#____#
#o#####o#o#######o#
#___#___#____#____#
#o#_#_#o#o##_#_##o#
#o#_o_#o#oE#_#_#Eo#
#o##o##o#o##_#_##o#
#______ooo________#
#######o#o#######o#
#_ooooooo_____###o#
#_#o#o#o#o#o#ooooo#
#_###o#o#o#o#####o#
#_______#________P#
###################