20x20
####################
#                  #
# ################ #
# #  Eooooooooooo# #
# # #o###    #  o# #
#   #ooo#    E  o# #
# #o###o#       o# #
# #ooooo#  #    o# #
# ########o#    o# #
# #oooooooo#    o# #
# #o############o# #
# #Eooooooooooooo# #
# # ############## #
# # # #   #   #  # #
# # #   #   #    # #
# # # ##########   #
# #   oooooooooo # #
# ################ #
#         P        #
####################